C 80,100,80                               
NO ./assets/dungeon_walls/SO.xpm
SO ./assets/dungeon_walls/SO.xpm
EA   ./assets/dungeon_walls/EA.xpm
WE   ./assets/dungeon_walls/EA.xpm
       F    234,182,118          

                        1111111
               1111111111000001111111111
               1000000000001000000000001
   1111111111  1000000000001000000000001  1111111111
   1000000001  100110000001 100001100001  1000000001
111100000000111100110000001 10000110000111100000000111
100000000000000000000000000100000000000000000000000001
100000000000000000000000000100000000000000000000000001
111100000000111100110000000000000110000111100000000111
   1000000001  1001100000001111111100001  1000000001
   1111111111  1000000000000000000000001  1111111111
               1000000000001000000000001
               1110111110011100111110111
               1000001000000000001000001
               100000100000N000001000001
               1111111111000001111111111
               1110111110011100111110111
              110000010000000000010000011
              100000000000000000000000001
              110000011110000011110000011
               1111111  1111111  1111111
