C 80,100,80
NO ./assets/dungeon_walls/NO.xpm
SO ./assets/dungeon_walls/SO.xpm
EA ./assets/dungeon_walls/EA.xpm
WE ./assets/dungeon_walls/WE.xpm
F 234,182,118


1111111111111111111111111111111111111111111111111111111111111111111111111111111111111111111111111111111
1000000000000000000000000000000001000000000001111010000000010000000000100001110000000000000010000000001
1000100000000000000010000000000001000010000000000010000000000010000000000001000010000000000010000000001
1000100000111101111110000111111111100010000111111111100111111111111001111111111111011111111111101011111
1000100000100000000010000000000001000010000100000010000000000010000000000001000010000100000100000000001
1000100000100000000010000111111111100010000100000010000111111111011111111111111011111111110100011111111
1000100000100000000010000000000000000010000000000010000100000000010000100000000000000000000100000010001
1000111111111111111111000111111111100011111111111110011111111111010111111101111111111111111100111111111
1000100000100000000010000100000111101110000100000010000100000000010000100000111111111100000100000100001
1000100000100000000010000100000100000010000100000010101100000000010000100000100000000010000100000100001
1000000000100000100000000100000100000000000000000000101100000100000100000100000100000100000100000000001
1000100000100000111110000100000000000011111100110000101100111111111100000100000111111111100000100000101
1000100000000000100000000100000100000000000100010000100000100000000000000100000000000000000010000100001
1000111111100000100011111100000100000111110100011111100000100000111111100111111100000111110111101111111
1000000000100000100000000100000100000100000100000000000100000100000100000100000100000100000100000N00001
1000011111100000100000111111111100011101111111111111011100111111111111011111101100011100011100000001111
1000000000100000100000000100000100000100000100000000000100000100000100000000001000001000000110000000001
1111111111111111111111111111111111111111111111111111111111111111111111111111111111111111111111111111111
